"filename", "language", "Python", "Markdown", "XML", "comment", "blank", "total"
"d:\Document\repo\History\HistoryApplication\Algorithm\K_Means.py", "Python", 120, 0, 0, 45, 24, 189
"d:\Document\repo\History\HistoryApplication\Algorithm\Proxy.py", "Python", 61, 0, 0, 26, 13, 100
"d:\Document\repo\History\HistoryApplication\Algorithm\__init__.py", "Python", 0, 0, 0, 0, 1, 1
"d:\Document\repo\History\HistoryApplication\Algorithm\apriori.py", "Python", 82, 0, 0, 1, 11, 94
"d:\Document\repo\History\HistoryApplication\Algorithm\dataIntegration.py", "Python", 67, 0, 0, 10, 10, 87
"d:\Document\repo\History\HistoryApplication\Algorithm\fpGrowth.py", "Python", 80, 0, 0, 7, 17, 104
"d:\Document\repo\History\HistoryApplication\Algorithm\kkkk.py", "Python", 96, 0, 0, 28, 13, 137
"d:\Document\repo\History\HistoryApplication\Algorithm\listen.py", "Python", 31, 0, 0, 45, 12, 88
"d:\Document\repo\History\HistoryApplication\Algorithm\recommend.py", "Python", 0, 0, 0, 0, 1, 1
"d:\Document\repo\History\HistoryApplication\Algorithm\test.py", "Python", 105, 0, 0, 37, 15, 157
"d:\Document\repo\History\HistoryApplication\Algorithm\visitVisible.py", "Python", 215, 0, 0, 17, 39, 271
"d:\Document\repo\History\HistoryApplication\IndexForm.py", "Python", 27, 0, 0, 7, 8, 42
"d:\Document\repo\History\HistoryApplication\Main.py", "Python", 22, 0, 0, 2, 9, 33
"d:\Document\repo\History\HistoryApplication\Resource\stopwords-master\README.md", "Markdown", 0, 9, 0, 0, 5, 14
"d:\Document\repo\History\HistoryApplication\UI\Index.ui", "XML", 0, 0, 55, 0, 1, 56
"d:\Document\repo\History\HistoryApplication\init.py", "Python", 6, 0, 0, 19, 3, 28
"Total", "-", 912, 9, 55, 244, 182, 1402